Province;Day;Date;New_cases;Curr_pos_cases;Deaths;Tot_deaths;Lethality_rate;Cumul_rates
Sassari;1;24/02/2020;0;0;0;0;0;0
Sassari;2;25/02/2020;0;0;0;0;0;0
Sassari;3;26/02/2020;0;0;0;0;0;0
Sassari;4;27/02/2020;0;0;0;0;0;0
Sassari;5;28/02/2020;0;0;0;0;0;0
Sassari;6;29/02/2020;0;0;0;0;0;0
Sassari;7;01/03/2020;0;0;0;0;0;0
Sassari;8;02/03/2020;0;0;0;0;0;0
Sassari;9;03/03/2020;0;0;0;0;0;0
Sassari;10;04/03/2020;0;0;0;0;0;0
Sassari;11;05/03/2020;0;0;0;0;0;0
Sassari;12;06/03/2020;0;0;0;0;0;0
Sassari;13;07/03/2020;0;0;0;0;0;0
Sassari;14;08/03/2020;0;0;0;0;0;0
Sassari;15;09/03/2020;1;1;0;0;0;0.203429413
Sassari;16;10/03/2020;0;1;0;0;0;0.203429413
Sassari;17;11/03/2020;1;2;0;0;0;0.406858826
Sassari;18;12/03/2020;2;4;0;0;0;0.813717652
Sassari;19;13/03/2020;0;4;0;0;0;0.813717652
Sassari;20;14/03/2020;2;6;0;0;0;1.220576478
Sassari;21;15/03/2020;29;35;1;1;0.028571429;7.120029457
Sassari;22;16/03/2020;22;57;0;1;0.01754386;11.59547654
Sassari;23;17/03/2020;6;63;0;1;0.015873016;12.81605302
Sassari;24;18/03/2020;11;74;0;1;0.013513514;15.05377657
Sassari;25;19/03/2020;60;134;0;1;0.007462687;27.25954135
Sassari;26;20/03/2020;82;216;0;1;0.00462963;43.94075322
Sassari;27;21/03/2020;35;251;4;5;0.019920319;51.06078267
Sassari;28;22/03/2020;2;253;0;5;0.019762846;51.4676415
Sassari;29;23/03/2020;7;260;4;9;0.034615385;52.89164739
Sassari;30;24/03/2020;49;309;4;13;0.042071197;62.85968863
Sassari;31;25/03/2020;9;318;2;15;0.047169811;64.69055335
Sassari;32;26/03/2020;13;331;0;15;0.045317221;67.33513572
Sassari;33;27/03/2020;5;336;2;17;0.050595238;68.35228278
Sassari;34;28/03/2020;71;407;3;20;0.049140049;82.79577111
Sassari;35;29/03/2020;8;415;0;20;0.048192771;84.42320641
Sassari;36;30/03/2020;39;454;1;21;0.046255507;92.35695352
Sassari;37;31/03/2020;32;486;1;22;0.04526749;98.86669474
Sassari;38;01/04/2020;11;497;1;23;0.046277666;101.1044183
Sassari;39;02/04/2020;31;528;4;27;0.051136364;107.4107301
Sassari;40;03/04/2020;19;547;1;28;0.0511883;111.2758889
Sassari;41;04/04/2020;38;585;0;28;0.047863248;119.0062066
Sassari;42;05/04/2020;16;601;2;30;0.049916805;122.2610772
Sassari;43;06/04/2020;9;610;4;34;0.055737705;124.091942
Sassari;44;07/04/2020;10;620;3;37;0.059677419;126.1262361
Sassari;45;08/04/2020;34;654;6;43;0.065749235;133.0428361
Sassari;46;09/04/2020;35;689;4;47;0.068214804;140.1628656
Sassari;47;10/04/2020;17;706;3;50;0.07082153;143.6211656
Sassari;48;11/04/2020;18;724;4;54;0.074585635;147.282895
Sassari;49;12/04/2020;13;737;0;54;0.073270014;149.9274774
Sassari;50;13/04/2020;8;745;1;55;0.073825503;151.5549127
Sassari;51;14/04/2020;4;749;2;57;0.076101469;152.3686304
Sassari;52;15/04/2020;14;763;1;58;0.076015727;155.2166422
Sassari;53;16/04/2020;1;764;2;60;0.078534031;155.4200716
Sassari;54;17/04/2020;10;774;0;60;0.07751938;157.4543657
Sassari;55;18/04/2020;15;789;0;60;0.076045627;160.5058069
Sassari;56;19/04/2020;7;796;0;60;0.075376884;161.9298128
Sassari;57;20/04/2020;2;798;0;60;0.07518797;162.3366716
Sassari;58;21/04/2020;0;798;5;65;0.081453634;162.3366716
Sassari;59;22/04/2020;6;804;2;67;0.083333333;163.5572481
Sassari;60;23/04/2020;6;810;0;67;0.082716049;164.7778246
Sassari;61;24/04/2020;1;811;0;67;0.082614057;164.981254
Sassari;62;25/04/2020;11;822;1;68;0.082725061;167.2189775
Sassari;63;26/04/2020;6;828;6;74;0.089371981;168.439554
Sassari;64;27/04/2020;1;829;0;74;0.089264174;168.6429834
Sassari;65;28/04/2020;1;830;0;74;0.089156627;168.8464128
Sassari;66;29/04/2020;3;833;7;81;0.097238896;169.4567011
Sassari;67;30/04/2020;3;836;0;81;0.096889952;170.0669893
Sassari;68;01/05/2020;12;848;0;81;0.095518868;172.5081423
Sassari;69;02/05/2020;0;848;0;81;0.095518868;172.5081423
Sassari;70;03/05/2020;0;848;0;81;0.095518868;172.5081423
Sassari;71;04/05/2020;0;848;0;81;0.095518868;172.5081423
Sassari;72;05/05/2020;0;848;0;81;0.095518868;172.5081423
Sassari;73;06/05/2020;1;849;0;81;0.09540636;172.7115717
Sassari;74;07/05/2020;5;854;0;81;0.094847775;173.7287187
Sassari;75;08/05/2020;6;860;0;81;0.094186047;174.9492952
Sassari;76;09/05/2020;3;863;0;81;0.093858633;175.5595835
Sassari;77;10/05/2020;3;866;1;82;0.094688222;176.1698717
Sassari;78;11/05/2020;0;866;0;82;0.094688222;176.1698717
Sassari;79;12/05/2020;0;866;0;82;0.094688222;176.1698717
Sassari;80;13/05/2020;0;866;0;82;0.094688222;176.1698717
Sassari;81;14/05/2020;0;866;0;82;0.094688222;176.1698717
Sassari;82;15/05/2020;3;869;0;82;0.094361335;176.7801599
Sassari;83;16/05/2020;2;871;0;82;0.094144661;177.1870188
Sassari;84;17/05/2020;0;871;0;82;0.094144661;177.1870188
Sassari;85;18/05/2020;0;871;0;82;0.094144661;177.1870188
Sassari;86;19/05/2020;0;871;0;82;0.094144661;177.1870188
Sassari;87;20/05/2020;1;872;0;82;0.094036697;177.3904482
Sassari;88;21/05/2020;0;872;0;82;0.094036697;177.3904482
Sassari;89;22/05/2020;0;872;0;82;0.094036697;177.3904482
Sassari;90;23/05/2020;-1;871;1;83;0.095292767;177.1870188
Sassari;91;24/05/2020;0;871;0;83;0.095292767;177.1870188
Sassari;92;25/05/2020;-1;870;0;83;0.095402299;176.9835893
Sassari;93;26/05/2020;0;870;0;83;0.095402299;176.9835893
Sassari;94;27/05/2020;0;870;0;83;0.095402299;176.9835893
Sassari;95;28/05/2020;0;870;0;83;0.095402299;176.9835893
Sassari;96;29/05/2020;0;870;0;83;0.095402299;176.9835893
Sassari;97;30/05/2020;0;870;0;83;0.095402299;176.9835893
Sassari;98;31/05/2020;0;870;0;83;0.095402299;176.9835893
Sassari;99;01/06/2020;0;870;0;83;0.095402299;176.9835893
Sassari;100;02/06/2020;0;870;0;83;0.095402299;176.9835893
Sassari;101;03/06/2020;0;870;0;83;0.0954;176.9835893
Sassari;102;04/06/2020;0;870;0;83;0.095402299;176.9835893
Sassari;103;05/06/2020;0;870;0;83;0.095402299;176.9835893
Sassari;104;06/06/2020;2;872;0;83;0.095183486;177.3904482
Sassari;105;07/06/2020;0;872;0;83;0.095183486;177.3904482
Sassari;106;08/06/2020;0;872;0;83;0.095183486;177.3904482
Sassari;107;09/06/2020;-1;871;0;83;0.095292767;177.1870188
Sassari;108;10/06/2020;0;871;0;83;0.095292767;177.1870188
Sassari;109;11/06/2020;3;874;0;83;0.094965675;177.797307
Sassari;110;12/06/2020;1;875;0;83;0.094857143;178.0007364
Sassari;111;13/06/2020;0;875;0;83;0.094857143;178.0007364
Sassari;112;14/06/2020;0;875;0;83;0.094857143;178.0007364
Sassari;113;15/06/2020;0;875;0;83;0.094857143;178.0007364
Sassari;114;16/06/2020;1;876;0;83;0.094748858;178.2041658
Sassari;115;17/06/2020;0;876;0;83;0.094748858;178.2041658
Sassari;116;18/06/2020;0;876;0;83;0.094748858;178.2041658
Sassari;117;19/06/2020;0;876;0;83;0.094748858;178.2041658
Sassari;118;20/06/2020;1;877;0;83;0.094640821;178.4075952
Sassari;119;21/06/2020;0;877;0;83;0.094640821;178.4075952
Sassari;120;22/06/2020;0;877;0;83;0.094640821;178.4075952
Sassari;121;23/06/2020;-4;873;0;83;0.095074456;177.5938776
Sassari;122;24/06/2020;0;873;0;83;0.095074456;177.5938776
Sassari;123;25/06/2020;0;873;0;83;0.095074456;177.5938776
Sassari;124;26/06/2020;0;873;0;83;0.095074456;177.5938776
Sassari;125;27/06/2020;0;873;0;83;0.095074456;177.5938776
Sassari;126;28/06/2020;0;873;0;83;0.095074456;177.5938776
Sassari;127;29/06/2020;0;873;0;83;0.095074456;177.5938776
Sassari;128;30/06/2020;2;875;0;83;0.094857143;178.0007364
Sassari;129;01/07/2020;0;875;0;83;0.094857143;178.0007364
Sassari;130;02/07/2020;0;875;0;83;0.094857143;178.0007364
Sassari;131;03/07/2020;1;876;0;83;0.094748858;178.2041658
Sassari;132;04/07/2020;0;876;0;83;0.094748858;178.2041658
Sassari;133;05/07/2020;1;877;0;83;0.094640821;178.4075952
Sassari;134;06/07/2020;0;877;1;84;0.095781072;178.4075952
Sassari;135;07/07/2020;0;877;0;84;0.095781072;178.4075952
Sassari;136;08/07/2020;0;877;0;84;0.095781072;178.4075952
Sassari;137;09/07/2020;0;877;0;84;0.095781072;178.4075952
Sassari;138;10/07/2020;0;877;0;84;0.095781072;178.4075952
Sassari;139;11/07/2020;0;877;0;84;0.095781072;178.4075952
Sassari;140;12/07/2020;0;877;0;84;0.095781072;178.4075952
Sassari;141;13/07/2020;1;878;0;84;0.095671982;178.6110247
Sassari;142;14/07/2020;0;878;0;84;0.095671982;178.6110247
Sassari;143;15/07/2020;0;878;0;84;0.095671982;178.6110247
Sassari;144;16/07/2020;0;878;0;84;0.095671982;178.6110247
Sassari;145;17/07/2020;0;878;0;84;0.095671982;178.6110247
Sassari;146;18/07/2020;0;878;0;84;0.095671982;178.6110247
Sassari;147;19/07/2020;1;879;0;84;0.09556314;178.8144541
Sassari;148;20/07/2020;0;879;0;84;0.09556314;178.8144541
Sassari;149;21/07/2020;0;879;0;84;0.09556314;178.8144541
Sassari;150;22/07/2020;0;879;0;84;0.09556314;178.8144541
Sassari;151;23/07/2020;1;880;0;84;0.095454545;179.0178835
Sassari;152;24/07/2020;1;881;0;84;0.095346198;179.2213129
Sassari;153;25/07/2020;3;884;0;84;0.095022624;179.8316011
Sassari;154;26/07/2020;0;884;0;84;0.095022624;179.8316011
Sassari;155;27/07/2020;-2;882;0;84;0.095238095;179.4247423
Sassari;156;28/07/2020;1;883;0;84;0.095130238;179.6281717
Sassari;157;29/07/2020;0;883;0;84;0.095130238;179.6281717
Sassari;158;30/07/2020;0;883;0;84;0.095130238;179.6281717
Sassari;159;31/07/2020;0;883;0;84;0.095130238;179.6281717
Sassari;160;01/08/2020;1;884;0;84;0.095022624;179.8316011
Sassari;161;02/08/2020;2;886;0;84;0.094808126;180.23846
Sassari;162;03/08/2020;1;887;0;84;0.09470124;180.4418894
Sassari;163;04/08/2020;0;887;0;84;0.09470124;180.4418894
Sassari;164;05/08/2020;1;888;0;84;0.094594595;180.6453188
Sassari;165;06/08/2020;0;888;0;84;0.094594595;180.6453188
Sassari;166;07/08/2020;0;888;0;84;0.094594595;180.6453188
Sassari;167;08/08/2020;0;888;0;84;0.094594595;180.6453188
Sassari;168;09/08/2020;0;888;0;84;0.094594595;180.6453188
Sassari;169;10/08/2020;2;890;0;84;0.094594595;180.6453188
Sassari;170;11/08/2020;8;898;0;84;0.094594595;180.6453188
Sassari;171;12/08/2020;0;898;0;84;0.094594595;180.6453188
Sassari;172;13/08/2020;0;898;0;84;0.094594595;180.6453188
Sassari;173;14/08/2020;3;901;0;84;0.094594595;180.6453188
Sassari;174;15/08/2020;0;901;0;84;0.094594595;180.6453188
Sassari;175;16/08/2020;4;905;0;84;0.094594595;180.6453188
