Province,Day,Date,New_cases,Curr_pos_cases,Deaths,Tot_deaths,Lethality_rate,Cumul_rates
Sassari,1,2020-02-24,0,0,0,0,0.00%,0
Sassari,2,2020-02-25,0,0,0,0,0.00%,0
Sassari,3,2020-02-26,0,0,0,0,0.00%,0
Sassari,4,2020-02-27,0,0,0,0,0.00%,0
Sassari,5,2020-02-28,0,0,0,0,0.00%,0
Sassari,6,2020-02-29,0,0,0,0,0.00%,0
Sassari,7,2020-03-01,0,0,0,0,0.00%,0
Sassari,8,2020-03-02,0,0,0,0,0.00%,0
Sassari,9,2020-03-03,0,0,0,0,0.00%,0
Sassari,10,2020-03-04,0,0,0,0,0.00%,0
Sassari,11,2020-03-05,0,0,0,0,0.00%,0
Sassari,12,2020-03-06,0,0,0,0,0.00%,0
Sassari,13,2020-03-07,0,0,0,0,0.00%,0
Sassari,14,2020-03-08,0,0,0,0,0.00%,0
Sassari,15,2020-03-09,1,1,0,0,0.00%,0.203429413045114
Sassari,16,2020-03-10,0,1,0,0,0.00%,0.203429413045114
Sassari,17,2020-03-11,1,2,0,0,0.00%,0.406858826090229
Sassari,18,2020-03-12,2,4,0,0,0.00%,0.813717652180458
Sassari,19,2020-03-13,0,4,0,0,0.00%,0.813717652180458
Sassari,20,2020-03-14,2,6,0,0,0.00%,1.22057647827069
Sassari,21,2020-03-15,29,35,1,1,2.86%,7.12002945657901
Sassari,22,2020-03-16,22,57,0,1,1.75%,11.5954765435715
Sassari,23,2020-03-17,6,63,0,1,1.59%,12.8160530218422
Sassari,24,2020-03-18,11,74,0,1,1.35%,15.0537765653385
Sassari,25,2020-03-19,60,134,0,1,0.75%,27.2595413480453
Sassari,26,2020-03-20,82,216,0,1,0.46%,43.9407532177447
Sassari,27,2020-03-21,35,251,4,5,1.99%,51.0607826743238
Sassari,28,2020-03-22,2,253,0,5,1.98%,51.467641500414
Sassari,29,2020-03-23,7,260,4,9,3.46%,52.8916473917298
Sassari,30,2020-03-24,49,309,4,13,4.21%,62.8596886309404
Sassari,31,2020-03-25,9,318,2,15,4.72%,64.6905533483464
Sassari,32,2020-03-26,13,331,0,15,4.53%,67.3351357179329
Sassari,33,2020-03-27,5,336,2,17,5.06%,68.3522827831585
Sassari,34,2020-03-28,71,407,3,20,4.91%,82.7957711093616
Sassari,35,2020-03-29,8,415,0,20,4.82%,84.4232064137225
Sassari,36,2020-03-30,39,454,1,21,4.63%,92.356953522482
Sassari,37,2020-03-31,32,486,1,22,4.53%,98.8666947399257
Sassari,38,2020-04-01,11,497,1,23,4.63%,101.104418283422
Sassari,39,2020-04-02,31,528,4,27,5.11%,107.41073008782
Sassari,40,2020-04-03,19,547,1,28,5.12%,111.275888935678
Sassari,41,2020-04-04,38,585,0,28,4.79%,119.006206631392
Sassari,42,2020-04-05,16,601,2,30,4.99%,122.261077240114
Sassari,43,2020-04-06,9,610,4,34,5.57%,124.09194195752
Sassari,44,2020-04-07,10,620,3,37,5.97%,126.126236087971
Sassari,45,2020-04-08,34,654,6,43,6.57%,133.042836131505
Sassari,46,2020-04-09,35,689,4,47,6.82%,140.162865588084
Sassari,47,2020-04-10,17,706,3,50,7.08%,143.621165609851
Sassari,48,2020-04-11,18,724,4,54,7.46%,147.282895044663
Sassari,49,2020-04-12,13,737,0,54,7.33%,149.927477414249
Sassari,50,2020-04-13,8,745,1,55,7.38%,151.55491271861
Sassari,51,2020-04-14,4,749,2,57,7.61%,152.368630370791
Sassari,52,2020-04-15,14,763,1,58,7.60%,155.216642153422
Sassari,53,2020-04-16,1,764,2,60,7.85%,155.420071566468
Sassari,54,2020-04-17,10,774,0,60,7.75%,157.454365696919
Sassari,55,2020-04-18,15,789,0,60,7.60%,160.505806892595
Sassari,56,2020-04-19,7,796,0,60,7.54%,161.929812783911
Sassari,57,2020-04-20,2,798,0,60,7.52%,162.336671610001
Sassari,58,2020-04-21,0,798,5,65,8.15%,162.336671610001
Sassari,59,2020-04-22,6,804,2,67,8.33%,163.557248088272
Sassari,60,2020-04-23,6,810,0,67,8.27%,164.777824566543
Sassari,61,2020-04-24,1,811,0,67,8.26%,164.981253979588
Sassari,62,2020-04-25,11,822,1,68,8.27%,167.218977523084
Sassari,63,2020-04-26,6,828,6,74,8.94%,168.439554001355
Sassari,64,2020-04-27,1,829,0,74,8.93%,168.6429834144
Sassari,65,2020-04-28,1,830,0,74,8.92%,168.846412827445
Sassari,66,2020-04-29,3,833,7,81,9.72%,169.45670106658
Sassari,67,2020-04-30,3,836,0,81,9.69%,170.066989305716
Sassari,68,2020-05-01,12,848,0,81,9.55%,172.508142262257
Sassari,69,2020-05-02,0,848,0,81,9.55%,172.508142262257
Sassari,70,2020-05-03,0,848,0,81,9.55%,172.508142262257
Sassari,71,2020-05-04,0,848,0,81,9.55%,172.508142262257
Sassari,72,2020-05-05,0,848,0,81,9.55%,172.508142262257
Sassari,73,2020-05-06,1,849,0,81,9.54%,172.711571675302
Sassari,74,2020-05-07,5,854,0,81,9.48%,173.728718740528
Sassari,75,2020-05-08,6,860,0,81,9.42%,174.949295218799
Sassari,76,2020-05-09,3,863,0,81,9.39%,175.559583457934
Sassari,77,2020-05-10,3,866,1,82,9.47%,176.169871697069
Sassari,78,2020-05-11,0,866,0,82,9.47%,176.169871697069
Sassari,79,2020-05-12,0,866,0,82,9.47%,176.169871697069
Sassari,80,2020-05-13,0,866,0,82,9.47%,176.169871697069
Sassari,81,2020-05-14,0,866,0,82,9.47%,176.169871697069
Sassari,82,2020-05-15,3,869,0,82,9.44%,176.780159936205
Sassari,83,2020-05-16,2,871,0,82,9.41%,177.187018762295
Sassari,84,2020-05-17,0,871,0,82,9.41%,177.187018762295
Sassari,85,2020-05-18,0,871,0,82,9.41%,177.187018762295
Sassari,86,2020-05-19,0,871,0,82,9.41%,177.187018762295
Sassari,87,2020-05-20,1,872,0,82,9.40%,177.39044817534
Sassari,88,2020-05-21,0,872,0,82,9.40%,177.39044817534
Sassari,89,2020-05-22,0,872,0,82,9.40%,177.39044817534
Sassari,90,2020-05-23,-1,871,1,83,9.53%,177.187018762295
Sassari,91,2020-05-24,0,871,0,83,9.53%,177.187018762295
Sassari,92,2020-05-25,-1,870,0,83,9.54%,176.98358934925
Sassari,93,2020-05-26,0,870,0,83,9.54%,176.98358934925
Sassari,94,2020-05-27,0,870,0,83,9.54%,176.98358934925
Sassari,95,2020-05-28,0,870,0,83,9.54%,176.98358934925
Sassari,96,2020-05-29,0,870,0,83,9.54%,176.98358934925
Sassari,97,2020-05-30,0,870,0,83,9.54%,176.98358934925
Sassari,98,2020-05-31,0,870,0,83,9.54%,176.98358934925
Sassari,99,2020-06-01,0,870,0,83,9.54%,176.98358934925
Sassari,100,2020-06-02,0,870,0,83,9.54%,176.98358934925
