Province,Day,Date,New_cases,Curr_pos_cases,Deaths,Tot_deaths,Lethality_rate,Cumul_rates
Sassari,1,2020-02-24,0,0,0,0,0.0,0.0
Sassari,2,2020-02-25,0,0,0,0,0.0,0.0
Sassari,3,2020-02-26,0,0,0,0,0.0,0.0
Sassari,4,2020-02-27,0,0,0,0,0.0,0.0
Sassari,5,2020-02-28,0,0,0,0,0.0,0.0
Sassari,6,2020-02-29,0,0,0,0,0.0,0.0
Sassari,7,2020-03-01,0,0,0,0,0.0,0.0
Sassari,8,2020-03-02,0,0,0,0,0.0,0.0
Sassari,9,2020-03-03,0,0,0,0,0.0,0.0
Sassari,10,2020-03-04,0,0,0,0,0.0,0.0
Sassari,11,2020-03-05,0,0,0,0,0.0,0.0
Sassari,12,2020-03-06,0,0,0,0,0.0,0.0
Sassari,13,2020-03-07,0,0,0,0,0.0,0.0
Sassari,14,2020-03-08,0,0,0,0,0.0,0.0
Sassari,15,2020-03-09,1,1,0,0,0.0,0.203429413045114
Sassari,16,2020-03-10,0,1,0,0,0.0,0.203429413045114
Sassari,17,2020-03-11,1,2,0,0,0.0,0.406858826090229
Sassari,18,2020-03-12,2,4,0,0,0.0,0.813717652180458
Sassari,19,2020-03-13,0,4,0,0,0.0,0.813717652180458
Sassari,20,2020-03-14,2,6,0,0,0.0,1.22057647827069
Sassari,21,2020-03-15,29,35,1,1,0.0285714285714286,7.120029456579009
Sassari,22,2020-03-16,22,57,0,1,0.0175438596491228,11.5954765435715
Sassari,23,2020-03-17,6,63,0,1,0.0158730158730159,12.816053021842198
Sassari,24,2020-03-18,11,74,0,1,0.0135135135135135,15.053776565338499
Sassari,25,2020-03-19,60,134,0,1,0.00746268656716418,27.2595413480453
Sassari,26,2020-03-20,82,216,0,1,0.0046296296296296285,43.94075321774472
Sassari,27,2020-03-21,35,251,4,5,0.0199203187250996,51.0607826743238
Sassari,28,2020-03-22,2,253,0,5,0.0197628458498024,51.467641500414
Sassari,29,2020-03-23,7,260,4,9,0.0346153846153846,52.89164739172979
Sassari,30,2020-03-24,49,309,4,13,0.0420711974110032,62.8596886309404
Sassari,31,2020-03-25,9,318,2,15,0.0471698113207547,64.6905533483464
Sassari,32,2020-03-26,13,331,0,15,0.0453172205438066,67.3351357179329
Sassari,33,2020-03-27,5,336,2,17,0.0505952380952381,68.3522827831585
Sassari,34,2020-03-28,71,407,3,20,0.0491400491400491,82.7957711093616
Sassari,35,2020-03-29,8,415,0,20,0.0481927710843374,84.4232064137225
Sassari,36,2020-03-30,39,454,1,21,0.0462555066079295,92.356953522482
Sassari,37,2020-03-31,32,486,1,22,0.0452674897119342,98.8666947399257
Sassari,38,2020-04-01,11,497,1,23,0.0462776659959759,101.10441828342199
Sassari,39,2020-04-02,31,528,4,27,0.0511363636363636,107.41073008782
Sassari,40,2020-04-03,19,547,1,28,0.0511882998171846,111.27588893567801
Sassari,41,2020-04-04,38,585,0,28,0.0478632478632479,119.006206631392
Sassari,42,2020-04-05,16,601,2,30,0.0499168053244592,122.261077240114
Sassari,43,2020-04-06,9,610,4,34,0.0557377049180328,124.09194195752
Sassari,44,2020-04-07,10,620,3,37,0.0596774193548387,126.126236087971
Sassari,45,2020-04-08,34,654,6,43,0.0657492354740061,133.042836131505
Sassari,46,2020-04-09,35,689,4,47,0.0682148040638607,140.162865588084
Sassari,47,2020-04-10,17,706,3,50,0.0708215297450425,143.621165609851
Sassari,48,2020-04-11,18,724,4,54,0.074585635359116,147.28289504466298
Sassari,49,2020-04-12,13,737,0,54,0.07327001356852099,149.927477414249
Sassari,50,2020-04-13,8,745,1,55,0.0738255033557047,151.55491271861
Sassari,51,2020-04-14,4,749,2,57,0.0761014686248331,152.368630370791
Sassari,52,2020-04-15,14,763,1,58,0.0760157273918742,155.216642153422
Sassari,53,2020-04-16,1,764,2,60,0.0785340314136126,155.42007156646798
Sassari,54,2020-04-17,10,774,0,60,0.0775193798449612,157.454365696919
Sassari,55,2020-04-18,15,789,0,60,0.0760456273764259,160.50580689259502
Sassari,56,2020-04-19,7,796,0,60,0.0753768844221105,161.929812783911
Sassari,57,2020-04-20,2,798,0,60,0.075187969924812,162.336671610001
Sassari,58,2020-04-21,0,798,5,65,0.081453634085213,162.336671610001
Sassari,59,2020-04-22,6,804,2,67,0.0833333333333333,163.557248088272
Sassari,60,2020-04-23,6,810,0,67,0.08271604938271601,164.77782456654302
Sassari,61,2020-04-24,1,811,0,67,0.0826140567200986,164.981253979588
Sassari,62,2020-04-25,11,822,1,68,0.0827250608272506,167.218977523084
Sassari,63,2020-04-26,6,828,6,74,0.0893719806763285,168.439554001355
Sassari,64,2020-04-27,1,829,0,74,0.0892641737032569,168.6429834144
Sassari,65,2020-04-28,1,830,0,74,0.0891566265060241,168.846412827445
Sassari,66,2020-04-29,3,833,7,81,0.0972388955582233,169.45670106658
Sassari,67,2020-04-30,3,836,0,81,0.0968899521531101,170.066989305716
Sassari,68,2020-05-01,12,848,0,81,0.0955188679245283,172.508142262257
Sassari,69,2020-05-02,0,848,0,81,0.0955188679245283,172.508142262257
Sassari,70,2020-05-03,0,848,0,81,0.0955188679245283,172.508142262257
Sassari,71,2020-05-04,0,848,0,81,0.0955188679245283,172.508142262257
Sassari,72,2020-05-05,0,848,0,81,0.0955188679245283,172.508142262257
Sassari,73,2020-05-06,1,849,0,81,0.0954063604240283,172.711571675302
Sassari,74,2020-05-07,5,854,0,81,0.094847775175644,173.728718740528
Sassari,75,2020-05-08,6,860,0,81,0.0941860465116279,174.94929521879902
Sassari,76,2020-05-09,3,863,0,81,0.0938586326767092,175.559583457934
Sassari,77,2020-05-10,3,866,1,82,0.0946882217090069,176.16987169706903
Sassari,78,2020-05-11,0,866,0,82,0.0946882217090069,176.16987169706903
Sassari,79,2020-05-12,0,866,0,82,0.0946882217090069,176.16987169706903
Sassari,80,2020-05-13,0,866,0,82,0.0946882217090069,176.16987169706903
Sassari,81,2020-05-14,0,866,0,82,0.0946882217090069,176.16987169706903
Sassari,82,2020-05-15,3,869,0,82,0.094361334867664,176.780159936205
Sassari,83,2020-05-16,2,871,0,82,0.0941446613088404,177.187018762295
Sassari,84,2020-05-17,0,871,0,82,0.0941446613088404,177.187018762295
Sassari,85,2020-05-18,0,871,0,82,0.0941446613088404,177.187018762295
Sassari,86,2020-05-19,0,871,0,82,0.0941446613088404,177.187018762295
Sassari,87,2020-05-20,1,872,0,82,0.0940366972477064,177.39044817534
Sassari,88,2020-05-21,0,872,0,82,0.0940366972477064,177.39044817534
Sassari,89,2020-05-22,0,872,0,82,0.0940366972477064,177.39044817534
Sassari,90,2020-05-23,-1,871,1,83,0.09529276693455804,177.187018762295
Sassari,91,2020-05-24,0,871,0,83,0.09529276693455804,177.187018762295
Sassari,92,2020-05-25,-1,870,0,83,0.0954022988505747,176.98358934925
Sassari,93,2020-05-26,0,870,0,83,0.0954022988505747,176.98358934925
Sassari,94,2020-05-27,0,870,0,83,0.0954022988505747,176.98358934925
Sassari,95,2020-05-28,0,870,0,83,0.0954022988505747,176.98358934925
Sassari,96,2020-05-29,0,870,0,83,0.0954022988505747,176.98358934925
Sassari,97,2020-05-30,0,870,0,83,0.0954022988505747,176.98358934925
Sassari,98,2020-05-31,0,870,0,83,0.0954022988505747,176.98358934925
Sassari,99,2020-06-01,0,870,0,83,0.0954022988505747,176.98358934925
Sassari,100,2020-06-02,0,870,0,83,0.0954022988505747,176.98358934925
Sassari,101,2020-06-03,0,870,0,83,0.0954,176.98358934925
Sassari,102,2020-06-04,0,870,0,83,0.09540229885057472,176.98358934924966
Sassari,103,2020-06-05,0,870,0,83,0.09540229885057472,176.98358934924966
Sassari,104,2020-06-06,2,872,0,83,0.09518348623853212,177.39044817533988
Sassari,105,2020-06-07,0,872,0,83,0.09518348623853212,177.39044817533988
Sassari,106,2020-06-08,0,872,0,83,0.09518348623853212,177.39044817533988
Sassari,107,2020-06-09,-1,871,0,83,0.09529276693455796,177.18701876229474
Sassari,108,2020-06-10,0,871,0,83,0.09529276693455796,177.18701876229474
Sassari,109,2020-06-11,3,874,0,83,0.09496567505720824,177.7973070014301
