Province,Day,Date,New_cases,Curr_pos_cases,Deaths,Tot_deaths,Lethality_rate,Cumul_rates
Roma,1,2020-02-24,0,0,0,0,0.0,0.0
Roma,2,2020-02-25,3,3,0,0,0.0,0.0690892107524921
Roma,3,2020-02-26,0,3,0,0,0.0,0.0690892107524921
Roma,4,2020-02-27,0,3,0,0,0.0,0.0690892107524921
Roma,5,2020-02-28,0,3,0,0,0.0,0.0690892107524921
Roma,6,2020-02-29,3,6,0,0,0.0,0.13817842150498402
Roma,7,2020-03-01,0,6,0,0,0.0,0.13817842150498402
Roma,8,2020-03-02,1,7,0,0,0.0,0.16120815842248098
Roma,9,2020-03-03,7,14,0,0,0.0,0.322416316844963
Roma,10,2020-03-04,15,29,0,0,0.0,0.6678623706074229
Roma,11,2020-03-05,13,42,0,0,0.0,0.9672489505348892
Roma,12,2020-03-06,7,49,1,1,0.0204081632653061,1.12845710895737
Roma,13,2020-03-07,22,71,0,1,0.0140845070422535,1.6351113211423105
Roma,14,2020-03-08,6,77,1,2,0.025974025974026,1.7732897426473
Roma,15,2020-03-09,14,91,2,4,0.043956043956044,2.09570605949226
Roma,16,2020-03-10,-15,76,0,4,0.0526315789473684,1.7502600057298001
Roma,17,2020-03-11,23,99,0,4,0.0404040404040404,2.27994395483224
Roma,18,2020-03-12,63,162,3,7,0.0432098765432099,3.73081738063457
Roma,19,2020-03-13,56,218,1,8,0.036697247706422007,5.020482648014419
Roma,20,2020-03-14,70,288,1,9,0.03125,6.6325642322392415
Roma,21,2020-03-15,66,354,1,10,0.0282485875706215,8.15252686879406
Roma,22,2020-03-16,58,412,3,13,0.0315533980582524,9.48825161000891
Roma,23,2020-03-17,74,486,2,15,0.0308641975308642,11.192452141903699
Roma,24,2020-03-18,104,590,4,19,0.0322033898305085,13.5875447813234
Roma,25,2020-03-19,88,678,6,25,0.0368731563421829,15.6141616300632
Roma,26,2020-03-20,77,755,5,30,0.0397350993377483,17.3874513727105
Roma,27,2020-03-21,138,893,9,39,0.0436730123180291,20.5655550673251
Roma,28,2020-03-22,156,1049,1,40,0.0381315538608198,24.1581940264547
Roma,29,2020-03-23,122,1171,7,47,0.040136635354397994,26.9678219303894
Roma,30,2020-03-24,116,1287,14,61,0.0473970473970474,29.6392714128191
Roma,31,2020-03-25,141,1428,9,70,0.0490196078431373,32.8864643181862
Roma,32,2020-03-26,139,1567,9,79,0.0504148053605616,36.0875977497183
Roma,33,2020-03-27,136,1703,7,86,0.0504991192014093,39.219641970497996
Roma,34,2020-03-28,136,1839,4,90,0.0489396411092985,42.3516861912776
Roma,35,2020-03-29,136,1945,7,97,0.0498714652956298,44.792838304532395
Roma,36,2020-03-30,123,2068,10,107,0.0517408123791103,47.6254959453845
Roma,37,2020-03-31,118,2186,8,115,0.0526075022872827,50.3430049016492
Roma,38,2020-04-01,74,2260,4,119,0.0526548672566372,52.04720543354399
Roma,39,2020-04-02,133,2393,11,130,0.0543251149185123,55.1101604435712
Roma,40,2020-04-03,110,2503,8,138,0.0551338393927287,57.6434315044959
Roma,41,2020-04-04,117,2620,10,148,0.0564885496183206,60.337910723843095
Roma,42,2020-04-05,94,2714,1,149,0.05490051584377298,62.5027059940878
Roma,43,2020-04-06,55,2769,7,156,0.0563380281690141,63.7693415245502
Roma,44,2020-04-07,61,2830,7,163,0.0575971731448763,65.1741554765175
Roma,45,2020-04-08,80,2910,5,168,0.0577319587628866,67.0165344299173
Roma,46,2020-04-09,116,3026,5,173,0.0571711830799736,69.68798391234701
Roma,47,2020-04-10,88,3114,7,180,0.0578034682080925,71.7146007610867
Roma,48,2020-04-11,105,3219,7,187,0.0580925753339546,74.13272313742401
Roma,49,2020-04-12,96,3315,4,191,0.0576168929110106,76.3435778815037
Roma,50,2020-04-13,116,3431,4,195,0.0568347420577091,79.01502736393341
Roma,51,2020-04-14,129,3560,15,210,0.0589887640449438,81.98586342629059
Roma,52,2020-04-15,105,3665,10,220,0.0600272851296044,84.40398580262779
Roma,53,2020-04-16,102,3767,3,223,0.0591983010353066,86.75301896821252
Roma,54,2020-04-17,121,3888,10,233,0.0599279835390947,89.5396171352297
Roma,55,2020-04-18,130,4018,7,240,0.0597312095569935,92.5334829345043
Roma,56,2020-04-19,64,4082,0,240,0.0587947084762371,94.0073860972242
Roma,57,2020-04-20,51,4133,5,245,0.0592789741108154,95.18190268001648
Roma,58,2020-04-21,56,4189,10,255,0.0608737168775364,96.47156794739641
Roma,59,2020-04-22,68,4257,5,260,0.0610758750293634,98.0375900577862
Roma,60,2020-04-23,56,4313,3,263,0.0609784372826339,99.32725532516608
Roma,61,2020-04-24,48,4361,8,271,0.062141710616831,100.432682697206
Roma,62,2020-04-25,73,4434,2,273,0.0615696887686062,102.113853492183
Roma,63,2020-04-26,67,4501,0,273,0.0606531881804044,103.656845865656
Roma,64,2020-04-27,68,4569,6,279,0.0610636900853578,105.222867976045
Roma,65,2020-04-28,73,4642,14,293,0.0631193451098664,106.90403877102301
Roma,66,2020-04-29,51,4693,6,299,0.0637119113573407,108.078555353815
Roma,67,2020-04-30,63,4756,10,309,0.0649705634987384,109.529428779617
Roma,68,2020-05-01,51,4807,7,316,0.0657374661951321,110.70394536241001
Roma,69,2020-05-02,56,4863,8,324,0.0666255397902529,111.99361062978998
Roma,70,2020-05-03,48,4911,10,334,0.0680105884748524,113.099038001829
Roma,71,2020-05-04,37,4948,12,346,0.0699272433306386,113.951138267777
Roma,72,2020-05-05,57,5005,5,351,0.0701298701298701,115.263833272074
Roma,73,2020-05-06,75,5080,3,354,0.0696850393700787,116.991063540887
Roma,74,2020-05-07,37,5117,5,359,0.0701582958764901,117.84316380683399
Roma,75,2020-05-08,47,5164,6,365,0.0706816421378776,118.925561441956
Roma,76,2020-05-09,38,5202,2,367,0.0705497885428681,119.800691444821
Roma,77,2020-05-10,27,5229,1,368,0.0703767450755403,120.422494341594
Roma,78,2020-05-11,21,5250,5,373,0.0710476190476191,120.906118816861
Roma,79,2020-05-12,16,5266,2,375,0.0712115457652868,121.274594607541
Roma,80,2020-05-13,25,5291,5,380,0.0718200718200718,121.850338030478
Roma,81,2020-05-14,17,5308,4,384,0.0723436322532027,122.241843558076
Roma,82,2020-05-15,63,5371,4,388,0.0722398063675293,123.692716983878
Roma,83,2020-05-16,26,5397,8,396,0.0733740967204002,124.291490143733
Roma,84,2020-05-17,39,5436,0,396,0.0728476821192053,125.18964988351601
Roma,85,2020-05-18,30,5466,2,398,0.0728137577753385,125.880541991041
Roma,86,2020-05-19,8,5474,9,407,0.0743514797223237,126.06477988638099
Roma,87,2020-05-20,20,5494,2,409,0.0744448489261012,126.52537462472999
Roma,88,2020-05-21,15,5509,4,413,0.0749682337992376,126.870820678493
Roma,89,2020-05-22,25,5534,6,419,0.0757137694253704,127.44656410143
Roma,90,2020-05-23,15,5549,2,421,0.0758695260407281,127.79201015519301
Roma,91,2020-05-24,16,5565,4,425,0.0763701707097933,128.160485945873
Roma,92,2020-05-25,11,5576,1,426,0.0763988522238164,128.413813051965
Roma,93,2020-05-26,15,5591,2,428,0.0765516007869791,128.759259105728
Roma,94,2020-05-27,9,5600,3,431,0.0769642857142857,128.966526737985
Roma,95,2020-05-28,14,5614,1,432,0.0769504809405059,129.28894305482999
Roma,96,2020-05-29,13,5627,7,439,0.0780167051714946,129.588329634758
Roma,97,2020-05-30,5,5632,5,444,0.0788352272727273,129.703478319345
Roma,98,2020-05-31,11,5643,7,451,0.0799220272904483,129.956805425438
Roma,99,2020-06-01,6,5649,1,452,0.0800141617985484,130.094983846943
Roma,100,2020-06-02,5,5654,0,452,0.0799434029006013,130.21013253153
Roma,101,2020-06-03,10,5664,2,454,0.0802,130.4
Roma,102,2020-06-04,11,5675,2,456,0.080352422907489,130.69375700679743
Roma,103,2020-06-05,9,5684,3,459,0.08075299085151302,130.90102463905492
Roma,104,2020-06-06,18,5702,1,460,0.08067344791301298,131.31555990356992
Roma,105,2020-06-07,17,5719,0,460,0.08043364224514775,131.70706543116734
Roma,106,2020-06-08,16,5735,3,463,0.08073234524847428,132.07554122184732
Roma,107,2020-06-09,19,5754,1,464,0.08063955509210984,132.51310622327975
Roma,108,2020-06-10,11,5765,4,468,0.08117953165654812,132.7664333293722
Roma,109,2020-06-11,16,5781,1,469,0.0811278325549213,133.1349091200522
Roma,110,2020-06-12,24,5805,3,472,0.08130921619293713,133.6876228060721
Roma,111,2020-06-13,25,5830,2,474,0.08130360205831902,134.2633662290095
Roma,112,2020-06-14,14,5844,1,475,0.08127994524298426,134.5857825458545
Roma,113,2020-06-15,3,5847,3,478,0.08175132546605096,134.654871756607
Roma,114,2020-06-16,9,5856,3,481,0.0821379781420765,134.86213938886448
Roma,115,2020-06-17,10,5866,4,485,0.08267984998295261,135.0924367580395
Roma,116,2020-06-18,8,5874,4,489,0.08324821246169561,135.27667465337942
Roma,117,2020-06-19,8,5882,0,489,0.08313498809928596,135.46091254871942
Roma,118,2020-06-20,12,5894,1,490,0.0831353919239905,135.73726939172934
Roma,119,2020-06-21,9,5903,0,490,0.08300863967474166,135.94453702398687
Roma,120,2020-06-22,8,5911,3,493,0.08340382338013873,136.12877491932682
Roma,121,2020-06-23,6,5917,2,495,0.08365725874598615,136.2669533408318
Roma,122,2020-06-24,-107,5810,1,496,0.08537005163511187,133.8027714906596
Roma,123,2020-06-25,7,5817,2,498,0.08561113976276431,133.9639796490821
Roma,124,2020-06-26,13,5830,1,499,0.0855917667238422,134.2633662290095
Roma,125,2020-06-27,16,5846,1,500,0.08552856654122477,134.63184201968951
Roma,126,2020-06-28,14,5860,0,500,0.08532423208191127,134.95425833653448
Roma,127,2020-06-29,8,5868,0,500,0.08520790729379686,135.13849623187446
Roma,128,2020-06-30,4,5872,0,500,0.08514986376021798,135.23061517954446
Roma,129,2020-07-01,8,5880,1,501,0.08520408163265306,135.4148530748844
Roma,130,2020-07-02,6,5886,0,501,0.08511722731906217,135.5530314963894
Roma,131,2020-07-03,10,5896,1,502,0.08514246947082768,135.7833288655644
Roma,132,2020-07-04,29,5925,1,503,0.08489451476793249,136.4511912361718
Roma,133,2020-07-05,11,5936,0,503,0.08473719676549865,136.7045183422643
Roma,134,2020-07-06,15,5951,1,504,0.08469164846244329,137.04996439602672
Roma,135,2020-07-07,6,5957,0,504,0.0846063454759107,137.1881428175317
Roma,136,2020-07-08,7,5964,0,504,0.08450704225352113,137.34935097595414
Roma,137,2020-07-09,30,5994,1,505,0.08425091758425092,138.0402430834791
Roma,138,2020-07-10,21,6015,1,506,0.08412302576891105,138.52386755874656
Roma,139,2020-07-11,12,6027,0,506,0.08395553343288535,138.8002244017565
Roma,140,2020-07-12,19,6046,0,506,0.08369169698974528,139.23778940318894
Roma,141,2020-07-13,21,6067,0,506,0.08340201087852316,139.72141387845642
Roma,142,2020-07-14,18,6085,1,507,0.08331963845521775,140.13594914297138
Roma,143,2020-07-15,18,6103,1,508,0.08323775192528265,140.5504844074863
Roma,144,2020-07-16,6,6109,1,509,0.08331969225732526,140.6886628289913
Roma,145,2020-07-17,11,6120,1,510,0.08333333333333333,140.94198993508374
Roma,146,2020-07-18,19,6139,0,510,0.08307541944942172,141.37955493651626
Roma,147,2020-07-19,13,6152,1,511,0.08306241872561769,141.6789415164437
Roma,148,2020-07-20,15,6167,0,511,0.08286038592508513,142.02438757020616
Roma,149,2020-07-21,3,6170,2,513,0.08314424635332253,142.09347678095864
Roma,150,2020-07-22,13,6183,2,515,0.08329289988678636,142.3928633608861
Roma,151,2020-07-23,23,6206,1,516,0.08314534321624234,142.92254730998854
Roma,152,2020-07-24,12,6218,1,517,0.08314570601479575,143.19890415299852
Roma,153,2020-07-25,15,6233,1,518,0.08310604845178887,143.54435020676095
Roma,154,2020-07-26,17,6250,2,520,0.0832,143.93585573435846
Roma,155,2020-07-27,9,6259,1,521,0.0832401342067423,144.1431233666159
Roma,156,2020-07-28,9,6268,1,522,0.08328015315890236,144.3503909988734
Roma,157,2020-07-29,32,6300,0,522,0.08285714285714285,145.0873425802333
