Province,Day,Date,New_cases,Curr_pos_cases,Deaths,Tot_deaths,Lethality_rate,Cumul_rates
Roma,1,24/02/2020,0,0,0,0,0,0
Roma,2,25/02/2020,3,3,0,0,0,0.07
Roma,3,26/02/2020,0,3,0,0,0,0.07
Roma,4,27/02/2020,0,3,0,0,0,0.07
Roma,5,28/02/2020,0,3,0,0,0,0.07
Roma,6,29/02/2020,3,6,0,0,0,0.14
Roma,7,01/03/2020,0,6,0,0,0,0.14
Roma,8,02/03/2020,1,7,0,0,0,0.16
Roma,9,03/03/2020,7,14,0,0,0,0.32
Roma,10,04/03/2020,15,29,0,0,0,0.67
Roma,11,05/03/2020,13,42,0,0,0,0.97
Roma,12,06/03/2020,7,49,1,1,0.02,1.13
Roma,13,07/03/2020,22,71,0,1,0.014,1.64
Roma,14,08/03/2020,6,77,1,2,0.026,1.77
Roma,15,09/03/2020,14,91,2,4,0.044,2.1
Roma,16,10/03/2020,-15,76,0,4,0.053,1.75
Roma,17,11/03/2020,23,99,0,4,0.04,2.28
Roma,18,12/03/2020,63,162,3,7,0.043,3.73
Roma,19,13/03/2020,56,218,1,8,0.037,5.02
Roma,20,14/03/2020,70,288,1,9,0.031,6.63
Roma,21,15/03/2020,66,354,1,10,0.028,8.15
Roma,22,16/03/2020,58,412,3,13,0.032,9.49
Roma,23,17/03/2020,74,486,2,15,0.031,11.19
Roma,24,18/03/2020,104,590,4,19,0.032,13.59
Roma,25,19/03/2020,88,678,6,25,0.037,15.61
Roma,26,20/03/2020,77,755,5,30,0.04,17.39
Roma,27,21/03/2020,138,893,9,39,0.044,20.57
Roma,28,22/03/2020,156,1049,1,40,0.038,24.16
Roma,29,23/03/2020,122,1171,7,47,0.04,26.97
Roma,30,24/03/2020,116,1287,14,61,0.047,29.64
Roma,31,25/03/2020,141,1428,9,70,0.049,32.89
Roma,32,26/03/2020,139,1567,9,79,0.05,36.09
Roma,33,27/03/2020,136,1703,7,86,0.05,39.22
Roma,34,28/03/2020,136,1839,4,90,0.049,42.35
Roma,35,29/03/2020,136,1945,7,97,0.05,44.79
Roma,36,30/03/2020,123,2068,10,107,0.052,47.63
Roma,37,31/03/2020,118,2186,8,115,0.053,50.34
Roma,38,01/04/2020,74,2260,4,119,0.053,52.05
Roma,39,02/04/2020,133,2393,11,130,0.054,55.11
Roma,40,03/04/2020,110,2503,8,138,0.055,57.64
Roma,41,04/04/2020,117,2620,10,148,0.056,60.34
Roma,42,05/04/2020,94,2714,1,149,0.055,62.5
Roma,43,06/04/2020,55,2769,7,156,0.056,63.77
Roma,44,07/04/2020,61,2830,7,163,0.058,65.17
Roma,45,08/04/2020,80,2910,5,168,0.058,67.02
Roma,46,09/04/2020,116,3026,5,173,0.057,69.69
Roma,47,10/04/2020,88,3114,7,180,0.058,71.71
Roma,48,11/04/2020,105,3219,7,187,0.058,74.13
Roma,49,12/04/2020,96,3315,4,191,0.058,76.34
Roma,50,13/04/2020,116,3431,4,195,0.057,79.02
Roma,51,14/04/2020,129,3560,15,210,0.059,81.99
Roma,52,15/04/2020,105,3665,10,220,0.06,84.4
Roma,53,16/04/2020,102,3767,3,223,0.059,86.75
Roma,54,17/04/2020,121,3888,10,233,0.06,89.54
Roma,55,18/04/2020,130,4018,7,240,0.06,92.53
Roma,56,19/04/2020,64,4082,0,240,0.059,94.01
Roma,57,20/04/2020,51,4133,5,245,0.059,95.18
Roma,58,21/04/2020,56,4189,10,255,0.061,96.47
Roma,59,22/04/2020,68,4257,5,260,0.061,98.04
Roma,60,23/04/2020,56,4313,3,263,0.061,99.33
Roma,61,24/04/2020,48,4361,8,271,0.062,100.43
Roma,62,25/04/2020,73,4434,2,273,0.062,102.11
Roma,63,26/04/2020,67,4501,0,273,0.061,103.66
Roma,64,27/04/2020,68,4569,6,279,0.061,105.22
Roma,65,28/04/2020,73,4642,14,293,0.063,106.9
Roma,66,29/04/2020,51,4693,6,299,0.064,108.08
Roma,67,30/04/2020,63,4756,10,309,0.065,109.53
Roma,68,01/05/2020,51,4807,7,316,0.066,110.7
Roma,69,02/05/2020,56,4863,8,324,0.067,111.99
Roma,70,03/05/2020,48,4911,10,334,0.068,113.1
Roma,71,04/05/2020,37,4948,12,346,0.07,113.95
Roma,72,05/05/2020,57,5005,5,351,0.07,115.26
Roma,73,06/05/2020,75,5080,3,354,0.07,116.99
Roma,74,07/05/2020,37,5117,5,359,0.07,117.84
Roma,75,08/05/2020,47,5164,6,365,0.071,118.93
Roma,76,09/05/2020,38,5202,2,367,0.071,119.8
Roma,77,10/05/2020,27,5229,1,368,0.07,120.42
Roma,78,11/05/2020,21,5250,5,373,0.071,120.91
Roma,79,12/05/2020,16,5266,2,375,0.071,121.27
Roma,80,13/05/2020,25,5291,5,380,0.072,121.85
Roma,81,14/05/2020,17,5308,4,384,0.072,122.24
Roma,82,15/05/2020,63,5371,4,388,0.072,123.69
Roma,83,16/05/2020,26,5397,8,396,0.073,124.29
Roma,84,17/05/2020,39,5436,0,396,0.073,125.19
Roma,85,18/05/2020,30,5466,2,398,0.073,125.88
Roma,86,19/05/2020,8,5474,9,407,0.074,126.06
Roma,87,20/05/2020,20,5494,2,409,0.074,126.53
Roma,88,21/05/2020,15,5509,4,413,0.075,126.87
Roma,89,22/05/2020,25,5534,6,419,0.076,127.45
Roma,90,23/05/2020,15,5549,2,421,0.076,127.79
Roma,91,24/05/2020,16,5565,4,425,0.076,128.16
Roma,92,25/05/2020,11,5576,1,426,0.076,128.41
Roma,93,26/05/2020,15,5591,2,428,0.077,128.76
Roma,94,27/05/2020,9,5600,3,431,0.077,128.97
Roma,95,28/05/2020,14,5614,1,432,0.077,129.29
Roma,96,29/05/2020,13,5627,7,439,0.078,129.59
Roma,97,30/05/2020,5,5632,5,444,0.079,129.7
Roma,98,31/05/2020,11,5643,7,451,0.08,129.96
Roma,99,01/06/2020,6,5649,1,452,0.08,130.09
Roma,100,02/06/2020,5,5654,0,452,0.08,130.21
Roma,101,03/06/2020,10,5664,2,454,0.08,130.44
Roma,102,04/06/2020,11,5675,2,456,0.08,130.69
Roma,103,05/06/2020,9,5684,3,459,0.081,130.9
Roma,104,06/06/2020,18,5702,1,460,0.081,131.32
Roma,105,07/06/2020,17,5719,0,460,0.08,131.71
Roma,106,08/06/2020,16,5735,3,463,0.081,132.08
Roma,107,09/06/2020,19,5754,1,464,0.081,132.51
Roma,108,10/06/2020,11,5765,4,468,0.081,132.77
Roma,109,11/06/2020,16,5781,1,469,0.081,133.13
Roma,110,12/06/2020,24,5805,3,472,0.081,133.69
Roma,111,13/06/2020,25,5830,2,474,0.081,134.26
Roma,112,14/06/2020,14,5844,1,475,0.081,134.59
Roma,113,15/06/2020,3,5847,3,478,0.082,134.65
Roma,114,16/06/2020,9,5856,3,481,0.082,134.86
Roma,115,17/06/2020,10,5866,4,485,0.083,135.09
Roma,116,18/06/2020,8,5874,4,489,0.083,135.28
Roma,117,19/06/2020,8,5882,0,489,0.083,135.46
Roma,118,20/06/2020,12,5894,1,490,0.083,135.74
Roma,119,21/06/2020,9,5903,0,490,0.083,135.94
Roma,120,22/06/2020,8,5911,3,493,0.083,136.13
Roma,121,23/06/2020,6,5917,2,495,0.084,136.27
Roma,122,24/06/2020,-107,5810,1,496,0.085,133.8
Roma,123,25/06/2020,7,5817,2,498,0.086,133.96
Roma,124,26/06/2020,13,5830,1,499,0.086,134.26
Roma,125,27/06/2020,16,5846,1,500,0.086,134.63
Roma,126,28/06/2020,14,5860,0,500,0.085,134.95
Roma,127,29/06/2020,8,5868,0,500,0.085,135.14
Roma,128,30/06/2020,4,5872,0,500,0.085,135.23
Roma,129,01/07/2020,8,5880,1,501,0.085,135.41
Roma,130,02/07/2020,6,5886,0,501,0.085,135.55
Roma,131,03/07/2020,10,5896,1,502,0.085,135.78
Roma,132,04/07/2020,29,5925,1,503,0.085,136.45
Roma,133,05/07/2020,11,5936,0,503,0.085,136.7
Roma,134,06/07/2020,15,5951,1,504,0.085,137.05
Roma,135,07/07/2020,6,5957,0,504,0.085,137.19
Roma,136,08/07/2020,7,5964,0,504,0.085,137.35
Roma,137,09/07/2020,30,5994,1,505,0.084,138.04
Roma,138,10/07/2020,21,6015,1,506,0.084,138.52
Roma,139,11/07/2020,12,6027,0,506,0.084,138.8
Roma,140,12/07/2020,19,6046,0,506,0.084,139.24
Roma,141,13/07/2020,21,6067,0,506,0.083,139.72
Roma,142,14/07/2020,18,6085,1,507,0.083,140.14
Roma,143,15/07/2020,18,6103,1,508,0.083,140.55
Roma,144,16/07/2020,6,6109,1,509,0.083,140.69
Roma,145,17/07/2020,11,6120,1,510,0.083,140.94
Roma,146,18/07/2020,19,6139,0,510,0.083,141.38
Roma,147,19/07/2020,13,6152,1,511,0.083,141.68
Roma,148,20/07/2020,15,6167,0,511,0.083,142.02
Roma,149,21/07/2020,3,6170,2,513,0.083,142.09
Roma,150,22/07/2020,13,6183,2,515,0.083,142.39
Roma,151,23/07/2020,23,6206,1,516,0.083,142.92
Roma,152,24/07/2020,12,6218,1,517,0.083,143.2
Roma,153,25/07/2020,15,6233,1,518,0.083,143.54
Roma,154,26/07/2020,17,6250,2,520,0.083,143.94
Roma,155,27/07/2020,9,6259,1,521,0.083,144.14
Roma,156,28/07/2020,9,6268,1,522,0.083,144.35
Roma,157,29/07/2020,32,6300,0,522,0.083,145.09
Roma,158,30/07/2020,16,6316,1,523,0.083,145.46
Roma,159,31/07/2020,13,6329,0,523,0.083,145.76
Roma,160,01/08/2020,12,6341,0,523,0.082,146.03
Roma,161,02/08/2020,14,6355,0,523,0.082,146.35
Roma,162,03/08/2020,12,6367,0,523,0.082,146.63
Roma,163,04/08/2020,13,6380,0,523,0.082,146.93
Roma,164,05/08/2020,5,6385,1,524,0.082,147.04
Roma,165,06/08/2020,13,6398,0,524,0.082,147.34
Roma,166,07/08/2020,18,6416,1,525,0.082,147.76
Roma,167,08/08/2020,15,6431,0,525,0.082,148.1
Roma,168,09/08/2020,32,6463,0,525,0.081,148.84
Roma,169,10/08/2020,28,6491,0,525,0.081,149.49
Roma,170,11/08/2020,20,6511,0,525,0.081,149.95
Roma,171,12/08/2020,31,6542,1,526,0.08,150.66
Roma,172,13/08/2020,26,6568,1,527,0.08,151.26
Roma,173,14/08/2020,41,6609,1,528,0.08,152.2
Roma,174,15/08/2020,42,6651,0,528,0.079,153.17
Roma,175,16/08/2020,54,6705,0,528,0.079,154.41
Roma,176,17/08/2020,49,6754,0,528,0.078,155.54
Roma,177,18/08/2020,37,6791,1,529,0.078,156.39
Roma,178,19/08/2020,72,6863,0,529,0.077,158.05
Roma,179,20/08/2020,100,6963,1,530,0.076,160.36
Roma,180,21/08/2020,122,7085,1,531,0.075,163.17
Roma,181,22/08/2020,153,7238,0,531,0.073,166.69
Roma,182,23/08/2020,140,7378,1,532,0.072,169.91
Roma,183,24/08/2020,141,7519,1,533,0.071,173.16
Roma,184,25/08/2020,117,7636,0,533,0.07,175.86
Roma,185,26/08/2020,149,7785,1,534,0.069,179.29
Roma,186,27/08/2020,115,7900,1,535,0.068,181.93
Roma,187,28/08/2020,131,8031,1,536,0.067,184.95
Roma,188,29/08/2020,131,8162,0,536,0.066,187.97
Roma,189,30/08/2020,106,8268,0,536,0.065,190.41
Roma,190,31/08/2020,122,8390,0,536,0.064,193.22
Roma,191,01/09/2020,105,8495,0,536,0.063,195.64
Roma,192,02/09/2020,107,8602,0,536,0.062,198.1
Roma,193,03/09/2020,129,8731,1,537,0.062,201.07
Roma,194,04/09/2020,138,8869,0,537,0.061,204.25
Roma,195,05/09/2020,131,9000,0,537,0.06,207.27
Roma,196,06/09/2020,101,9101,1,538,0.059,209.59
Roma,197,07/09/2020,133,9234,0,538,0.058,212.66
Roma,198,08/09/2020,114,9348,0,538,0.058,215.28
Roma,199,09/09/2020,129,9477,0,538,0.057,218.25
Roma,200,10/09/2020,136,9613,1,539,0.056,221.38
Roma,201,11/09/2020,130,9743,1,540,0.055,224.38
Roma,202,12/09/2020,131,9874,1,541,0.055,227.4
Roma,203,13/09/2020,127,10001,1,542,0.054,230.32
Roma,204,14/09/2020,129,10130,0,542,0.054,233.29
Roma,205,15/09/2020,120,10250,2,544,0.053,236.05
Roma,206,16/09/2020,117,10367,0,544,0.052,238.75
Roma,207,17/09/2020,152,10519,2,546,0.052,242.25
Roma,208,18/09/2020,157,10676,0,546,0.051,245.87
Roma,209,19/09/2020,154,10830,1,547,0.051,249.41
Roma,210,20/09/2020,131,10961,0,547,0.05,252.43
Roma,211,21/09/2020,168,11129,3,550,0.049,256.3
Roma,212,22/09/2020,165,11294,4,554,0.049,260.1
Roma,213,23/09/2020,161,11455,3,557,0.049,263.81
Roma,214,24/09/2020,200,11655,0,557,0.048,268.41
Roma,215,25/09/2020,173,11828,2,559,0.047,272.4
Roma,216,26/09/2020,148,11976,2,561,0.047,275.8
Roma,217,27/09/2020,140,12116,0,561,0.046,279.03
Roma,218,28/09/2020,149,12265,2,563,0.046,282.46
Roma,219,29/09/2020,359,12624,0,563,0.045,290.73
Roma,220,30/09/2020,0,12624,2,565,0.045,290.73
Roma,221,01/10/2020,233,12857,4,569,0.044,296.09
Roma,222,02/10/2020,193,13050,5,569,0.044,300.54
Roma,223,03/10/2020,182,13232,5,569,0.043,304.73
